noc,participants,gold,silver,bronze,all_medals,gdp,population
Albania,4,0,0,0,0,9523,3474
Algeria,47,1,1,3,5,87109,30429
Angola,30,0,0,0,0,7991,10377
Argentina,143,0,2,2,4,320364,37336
Armenia,25,0,0,1,1,13889,3043
Australia,632,16,25,17,58,414058,19053
Austria,92,2,1,0,3,167878,8113
Azerbaijan,29,2,0,1,3,19666,7809
Bahrain,4,0,0,0,0,3208,634
Bangladesh,4,0,0,0,0,112371,136681
Belarus,139,3,3,11,17,64943,10034
Belgium,68,0,2,3,5,212010,10264
Benin,4,0,0,0,0,8503,6619
Bolivia,5,0,0,0,0,20991,8195
Bosnia and Herzegovina,9,0,0,0,0,22487,4035
Botswana,7,0,0,0,0,6860,1680
Brazil,205,0,6,6,12,975444,176320
Bulgaria,91,5,6,2,13,41828,7818
Burkina Faso,2,0,0,0,0,10416,11588
Burundi,6,0,0,0,0,3284,6621
Cambodia,4,0,0,0,0,14224,12396
Cameroon,34,1,0,0,1,16488,15343
Canada,294,3,3,8,14,699382,31100
Cape Verde,2,0,0,0,0,713,402
Central African Republic,3,0,0,0,0,2265,3940
Chad,2,0,0,0,0,3566,7943
Chile,50,0,0,1,1,156245,15156
China,271,28,16,14,58,4319339,1262645
Colombia,44,1,0,0,1,202230,39817
DR Congo,3,0,0,0,0,11286,51849
Congo,4,0,0,0,0,6221,3104
Costa Rica,7,0,0,2,2,22908,3711
CÃ´te d'Ivoire,14,0,0,0,0,21042,16885
Croatia,88,1,0,1,2,28400,4411
Cuba,229,11,11,7,29,26896,11106
Czech Republic,119,2,3,3,8,94029,10270
Denmark,97,2,3,1,6,122628,5337
Djibouti,2,0,0,0,0,475,431
Dominican Republic,13,0,0,0,0,30600,8410
Ecuador,10,0,0,0,0,40059,12446
Egypt,89,0,0,0,0,207013,70512
El Salvador,8,0,0,0,0,16626,6126
Equatorial Guinea,4,0,0,0,0,3773,491
Estonia,33,1,0,2,3,16158,1380
Finland,70,2,1,1,4,102185,5169
France,336,13,14,11,38,1248521,61137
Gabon,5,0,0,0,0,4753,1236
Gambia,2,0,0,0,0,1224,1368
Georgia,36,0,0,6,6,15495,4777
Germany,422,13,17,26,56,1556928,82188
Ghana,22,0,0,0,0,24963,19736
Great Britain,332,11,10,7,28,1211453,59522
Greece,140,4,6,3,13,127880,10559
Guatemala,15,0,0,0,0,43533,11085
Guinea,6,0,0,0,0,4939,8350
Haiti,5,0,0,0,0,5817,7639
Honduras,20,0,0,0,0,12134,6348
Hong Kong,31,0,0,0,0,155337,6659
Hungary,178,8,6,3,17,72303,10137
India,0,0,0,1,1,1899526,1004124
Indonesia,47,1,3,2,6,672114,205132
Iran,35,3,0,1,4,306112,63273
Iraq,4,0,0,0,0,27692,22676
Ireland,64,0,1,0,1,81716,3792
Israel,39,0,0,1,1,98887,6115
Italy,361,13,8,13,34,1083598,57719
Jamaica,48,0,5,4,9,9411,2615
Japan,266,5,8,5,18,2628056,126729
Jordan,8,0,0,0,0,20437,4999
Kazakhstan,130,3,4,0,7,84902,15032
Kenya,56,2,3,2,7,30906,30508
North Korea,31,0,1,3,4,25310,21263
South Korea,281,8,10,10,28,673289,46839
Kuwait,29,0,0,1,1,19899,1974
Kyrgyzstan,18,0,0,1,1,10515,4851
Laos,3,0,0,0,0,6615,5498
Latvia,45,1,1,1,3,18281,2376
Lebanon,6,0,0,0,0,12184,3581
Lesotho,6,0,0,0,0,3037,2068
Liberia,8,0,0,0,0,2667,2695
Libya,3,0,0,0,0,11832,5115
Lithuania,61,2,0,3,5,23192,3654
Macedonia,8,0,0,1,1,6730,2015
Madagascar,11,0,0,0,0,10946,15742
Malawi,2,0,0,0,0,7388,11560
Malaysia,40,0,0,0,0,177955,21804
Mali,5,0,0,0,0,8981,10049
Mauritania,2,0,0,0,0,2713,2501
Mauritius,20,0,0,0,0,12563,1186
Mexico,78,1,2,3,6,726934,99927
Moldova,34,0,1,1,2,9425,4391
Mongolia,20,0,0,0,0,2821,2664
Morocco,55,0,1,4,5,80052,30184
Mozambique,5,1,0,0,1,24252,18125
Namibia,12,0,0,0,0,6931,1893
Nepal,5,0,0,0,0,24681,24818
Netherlands,243,12,9,4,25,352541,15908
New Zealand,151,1,0,3,4,61766,3802
Nicaragua,6,0,0,0,0,7500,4935
Niger,4,0,0,0,0,5115,10951
Nigeria,83,0,3,0,3,143018,123179
Norway,95,4,3,3,10,112768,4492
Oman,6,0,0,0,0,18027,2534
Pakistan,26,0,0,0,0,265634,146405
Panama,6,0,0,0,0,16400,2900
Paraguay,5,0,0,0,0,16835,5592
Peru,21,0,0,0,0,99573,26087
Philippines,21,0,0,0,0,193066,81222
Poland,187,6,5,3,14,282517,38654
Portugal,62,0,0,2,2,142770,10336
Puerto Rico,29,0,0,0,0,53826,3814
Qatar,17,0,0,1,1,6172,627
Romania,145,11,6,9,26,67480,22452
Russia,435,32,28,29,89,774253,146710
Rwanda,5,0,0,0,0,6146,8278
Saudi Arabia,0,0,1,1,2,177068,23147
Senegal,26,0,0,0,0,14022,10678
Seychelles,9,0,0,0,0,504,79
Sierra Leone,3,0,0,0,0,1971,4816
Singapore,14,0,0,0,0,90900,4037
Slovakia,114,1,3,1,5,44389,5400
Slovenia,74,2,0,0,2,25889,2011
Somalia,2,0,0,0,0,6260,7386
South Africa,127,0,2,3,5,175305,45064
Spain,326,3,3,5,11,625120,40016
Sri Lanka,18,0,1,0,1,69913,19436
Sudan,3,0,0,0,0,34773,34194
Swaziland,6,0,0,0,0,2919,1110
Sweden,149,4,5,3,12,183739,8872
Switzerland,105,1,6,2,9,163323,7267
Syria,8,0,0,0,0,120145,16306
Chinese Taipei,74,0,1,4,5,373438,22133
Tajikistan,4,0,0,0,0,5688,6230
Tanzania,4,0,0,0,0,17694,33712
Thailand,52,1,0,2,3,395791,61863
Togo,3,0,0,0,0,2894,4712
Trinidad and Tobago,19,0,1,1,2,15299,1252
Tunisia,47,0,0,0,0,43537,9568
Turkey,57,3,0,2,5,433992,67329
Turkmenistan,8,0,0,0,0,10503,4385
Uganda,13,0,0,0,0,18518,23956
Ukraine,230,3,10,10,23,134542,49005
United Arab Emirates,4,0,0,0,0,41621,3219
United States,586,37,24,33,94,8032209,282158
Uruguay,14,0,1,0,1,26203,3328
Uzbekistan,70,1,1,2,4,86123,25042
Venezuela,50,0,0,0,0,198105,23493
Vietnam,7,0,1,0,1,143002,79060
Yemen,2,0,0,0,0,45783,17495
Yugoslavia,111,1,1,1,3,108609,22507
Zambia,8,0,0,0,0,6529,10205
Zimbabwe,16,0,0,0,0,15604,11820
