noc,participants,gold,silver,bronze,all_medals,gdp,population
Afghanistan,3,0,0,0,0,19535,28514
Albania,7,0,0,0,0,11849,3545
Algeria,63,0,0,0,0,104529,32158
Angola,31,0,0,0,0,10836,11391
Argentina,156,2,0,4,6,323609,38742
Armenia,19,0,0,0,0,22052,2991
Australia,482,17,16,16,49,472265,19995
Austria,101,2,4,1,7,176795,8175
Azerbaijan,38,1,0,4,5,29644,7968
Bahrain,6,0,0,0,0,3997,678
Bangladesh,4,0,0,0,0,138328,145905
Belarus,151,2,6,7,15,84943,9856
Belgium,62,1,0,2,3,225609,10348
Benin,4,0,0,0,0,10138,7527
Bolivia,7,0,0,0,0,23396,8896
Bosnia and Herzegovina,9,0,0,0,0,26682,4346
Botswana,11,0,0,0,0,8115,1808
Brazil,247,5,2,3,10,1076423,186489
Bulgaria,165,2,1,9,12,50785,7518
Burkina Faso,5,0,0,0,0,13208,13478
Burundi,7,0,0,0,0,3627,7516
Cambodia,4,0,0,0,0,23944,13300
Cameroon,17,1,0,0,1,19941,16873
Canada,262,3,6,3,12,769405,32135
Cape Verde,3,0,0,0,0,867,416
Central African Republic,4,0,0,0,0,2114,4178
Chad,2,0,0,0,0,6600,9098
Chile,56,2,0,1,3,181775,15836
China,407,32,17,14,63,6699034,1296075
Colombia,51,0,0,2,2,229067,42454
DR Congo,4,0,0,0,0,12898,58630
Congo,5,0,0,0,0,7087,3504
Costa Rica,20,0,0,0,0,26448,3959
CÃ´te d'Ivoire,5,0,0,0,0,20720,18504
Croatia,83,1,2,2,5,33931,4497
Cuba,151,9,7,11,27,30879,11288
Czech Republic,142,1,3,4,8,106318,10246
Denmark,92,2,0,6,8,127175,5413
Djibouti,1,0,0,0,0,528,467
Dominican Republic,33,1,0,0,1,33446,8951
Ecuador,17,0,0,0,0,47604,13368
Egypt,96,1,1,3,5,237546,76166
El Salvador,8,0,0,0,0,18021,6594
Equatorial Guinea,2,0,0,0,0,9052,551
Estonia,44,0,1,2,3,20978,1342
Finland,62,0,2,0,2,112500,5215
France,317,11,9,13,33,1329614,62534
Gabon,6,0,0,0,0,5029,1364
Gambia,2,0,0,0,0,1434,1549
Georgia,32,2,2,0,4,20157,4694
Germany,479,13,16,20,49,1589449,82425
Ghana,29,0,0,0,0,30197,21572
Great Britain,259,9,9,12,30,1331721,60271
Greece,441,6,6,4,16,152462,10648
Guatemala,18,0,0,0,0,48184,11940
Guinea,3,0,0,0,0,5459,8972
Haiti,8,0,0,0,0,5545,8235
Honduras,5,0,0,0,0,14193,7007
Hong Kong,32,0,1,0,1,178216,6855
Hungary,219,8,6,3,17,85761,10032
India,73,0,1,0,1,2426453,1065071
Indonesia,38,1,1,2,4,801266,216041
Iran,37,2,2,2,6,373743,64326
Iraq,25,0,0,0,0,25256,25375
Ireland,52,0,0,0,0,100745,3970
Israel,36,1,0,1,2,105360,6618
Italy,364,10,11,11,32,1120504,58057
Jamaica,47,2,1,2,5,10151,2713
Japan,312,16,9,12,37,2750543,127480
Jordan,8,0,0,0,0,25765,5611
Kazakhstan,114,1,4,3,8,126402,15144
Kenya,46,1,4,2,7,33968,33967
North Korea,36,0,4,1,5,25310,22054
South Korea,264,9,12,9,30,807459,47854
Kuwait,29,0,0,0,0,26438,2258
Kyrgyzstan,11,0,0,0,0,12641,5081
Laos,5,0,0,0,0,8331,6068
Latvia,35,0,4,0,4,25548,2306
Lebanon,8,0,0,0,0,14705,3781
Lesotho,3,0,0,0,0,3508,2114
Liberia,2,0,0,0,0,2010,2809
Libya,8,0,0,0,0,14127,5632
Lithuania,59,1,2,0,3,31022,3608
Macedonia,10,0,0,0,0,6981,2040
Madagascar,8,0,0,0,0,11711,17768
Malawi,4,0,0,0,0,7892,12677
Malaysia,26,0,0,0,0,210191,23535
Mali,23,0,0,0,0,11527,11091
Mauritania,2,0,0,0,0,3275,2768
Mauritius,9,0,0,0,0,15574,1232
Mexico,109,0,3,1,4,772208,104960
Moldova,33,0,0,0,0,12307,4347
Mongolia,20,0,0,1,1,3000,2825
Morocco,55,2,1,0,3,98820,32275
Mozambique,4,0,0,0,0,34140,19773
Namibia,8,0,0,0,0,8011,2007
Nepal,6,0,0,0,0,27676,26708
Netherlands,219,4,9,9,22,368824,16318
New Zealand,148,3,2,0,5,71790,4008
Nicaragua,5,0,0,0,0,8392,4363
Niger,4,0,0,0,0,5850,12705
Nigeria,70,0,0,2,2,175618,134605
Norway,52,5,0,1,6,122439,4575
Oman,2,0,0,0,0,21375,2905
Pakistan,26,0,0,0,0,314348,159266
Panama,4,0,0,0,0,18219,3104
Paraguay,22,0,1,0,1,18559,6195
Peru,9,0,0,0,0,114315,27665
Philippines,16,0,0,0,0,228776,88622
Poland,208,3,2,5,10,317349,38580
Portugal,91,0,2,1,3,147841,10524
Puerto Rico,43,0,0,0,0,57069,3894
Qatar,22,0,0,0,0,8471,759
Romania,108,8,5,6,19,85241,22356
Russia,456,27,27,38,92,980002,143507
Rwanda,5,0,0,0,0,7528,9128
Saudi Arabia,16,0,0,0,0,202015,25784
Senegal,16,0,0,0,0,16743,11941
Serbia and Montenegro,85,0,2,0,2,29936,9987
Seychelles,9,0,0,0,0,456,83
Sierra Leone,2,0,0,0,0,3420,5739
Singapore,16,0,0,0,0,102174,4354
Slovakia,64,2,2,2,6,52383,5424
Slovenia,79,0,1,3,4,29880,2011
Somalia,2,0,0,0,0,7432,8459
South Africa,106,1,3,2,6,195473,47033
Spain,316,3,11,5,19,708466,40281
Sri Lanka,8,0,0,0,0,79876,20303
Sudan,4,0,0,0,0,44021,37097
Swaziland,3,0,0,0,0,3191,1138
Sweden,115,4,2,1,7,200316,8986
Switzerland,98,1,1,3,5,169781,7451
Syria,6,0,0,1,1,137128,18017
Chinese Taipei,87,2,2,1,5,415128,22622
Tajikistan,9,0,0,0,0,8366,6688
Tanzania,8,0,0,0,0,22719,36990
Thailand,42,3,1,4,8,483882,63731
Togo,3,0,0,0,0,3275,5255
Trinidad and Tobago,19,0,0,1,1,20335,1239
Tunisia,54,0,0,0,0,51991,9979
Turkey,53,3,3,4,10,499422,71614
Turkmenistan,9,0,0,0,0,13634,4608
Uganda,11,0,0,0,0,22729,27234
Ukraine,239,9,5,9,23,189548,47305
United Arab Emirates,4,1,0,0,1,53311,3908
United States,536,36,39,27,102,8738865,292806
Uruguay,15,0,0,0,0,25744,3406
Uzbekistan,70,2,1,2,5,105444,26268
Venezuela,48,0,0,2,2,203627,24905
Vietnam,11,0,0,0,0,189263,82663
Yemen,3,0,0,0,0,53251,20043
Zambia,6,0,0,0,0,7836,10962
Zimbabwe,13,1,1,1,3,12301,11735
